##########################################################################################
#@..#....................................................................................#
#........................................................................................#
#####....................................................................................#
#........................................................................................#
#........................................................................................#
#........................................................................................#
#........................................................................................#
#........................................................................................#
#........................................................................................#
#........................................................................................#
#........................................................................................#
#........................................................................................#
#........................................................................................#
#........................................................................................#
#........................................................................................#
#........................................................................................#
#........................................................................................#
#........................................................................................#
#........................................................................................#
#........................................................................................#
##########################################################################################